$$$$$$$$
$ $t$  $
$$$ $$$$
$      $
$      $
$$$ $$$$
$  s   $
$$$$$$$$