$$$$$$$$$$$$$$$$$
$   $   $       $
$ $ $ $ $ $$$$$ $
$ $ $ $   $   $ $
$ $ $ $$$ $ $ $ $
$ $ $   $ $ $   $
$ $ $ $ $ $$$$$$$
$ $ $ $ $t$   $ $
$ $$$ $$$$$ $ $ $
$   $ $     $ $ $
$ $$$ $ $$$ $ $ $
$ $ $ $ $   $   $
$$$ $ $$$ $$$ $ $
$     $       $ $
$$$$$ $$$$$$$$$$$
$   $s$         $
$$$$$$$$$$$$$$$$$